accueil: [[home, main page, page d’accueil]]
fauteuil: [[armstoel, leunstoel, luie stoel]]
meuble: [[garniture, mobilier]]
militaire: [[martial, guerrier], [soldat, trouffion, bidasse, chair à canon, fantassin, gendarme, mercenaire, milicien]]
manchot: [[unibrassiste], [manchois]]
bande dessinée: [[art, bédé, illustré, neuvième art, roman graphique]]
bird: [[porridge, time, stretch]]
allemand: [[langue allemande, langue de Goethe, langue des chevaux]]
vendredi: [[dredi]]
voler: [[desitjar], [volença, volontat]]
armée: [[doel, paine, enui, dulor], [arme, force, force navale, force terrestre, force d’intervention, drapeau]]
sinogramme: [[caractère chinois, hanja, hanzi, kanji]]
kanji: [[caractère chinois, sinogramme, hanja, hanzi]]
jour: [[journée]]
CD-ROM: [[CD, disque optique compact]]
photographie: [[photo, prise de vue]]
ordinateur: [[ordonnateur]]
mars: [[ugglemånad, vårmånad]]
mai: [[mois de Marie], [jamai, anc], [non], [encara], [mama], [din nou, iar, iarăși]]
computer: [[ordinateur], [pc, homecomputer]]
anglais: [[anglophone], [angliche, langue anglaise, langue de Shakespeare]]
lieu: [[endroit, emplacement, localité, place]]
hypothèse: [[conjecture, postulat]]
collaboration: [[collaborativité]]
prendre: [[agafar]]
le: [[émouvable, émotif]]
la: [[na], [lan], [lade]]
fin: [[finman], [final, término]]
abréviation: [[abréviature]]
火: [[불], [mardi]]
procrastiner: [[atermoyer]]
sprechen: [[reden]]
Buchhandlung: [[Buchladen]]
espagnol: [[castillan, espingouin, langue de Cervantes, langue espagnole]]
neuf: [[nouveau], [nouveau]]
et: [[ainsi que, comme, pis, plus, puis], [ac, -que]]
un: [[quelque], [l’un, quelqu’un], [empreu], [uno]]
nord: [[septentrion], [boréal, septentrional], [norte]]
sud: [[austro, méridien, midi, miéjour], [austral, méridional]]
Samstag: [[Sonnabend]]
dico: [[lego], [for, loquor]]
je: [[moi, égo], [jemals, jeweils]]
mot: [[Wiktionnaire:BCP 47, Wiktionnaire:ISO 639-1, Wiktionnaire:ISO 639-2, Wiktionnaire:ISO 639-3, Wiktionnaire:Vérification des modèles pour les langues], [écrit, parole], [nagvlinder], [paraula], [geschil, herrie, nachtvlinder, onmin, ruzie, strijd, tweespalt], [emot, gentemot, inemot]]
personne: [[dégun, nul]]
lès: [[synonyme 1, synonyme 2]]
nom commun: [[nom, substantif, locution nominale]]
des: [[de chez], [adesea]]
俺: [[synonyme 1, synonyme 2]]
Toulouse: [[Cité des violettes, Ville rose]]
O: [[W]]
japonais: [[nippon], [langue de Mishima, langue japonaise], [arlequin]]
portugais: [[langue de Camões]]
ordre: [[bestilling]]
deux: [[couple, paire]]
Internet: [[net], [web]]
courriel: [[courrier électronique, e-mail, mail, mél, message électronique]]
pourriel: [[courriel indésirable, merdiel, spam, polluriel]]
arriver: [[atteindre, réussir, parvenir]]
ensemble: [[coude à coude, de concert, de conserve, en chœur, ensemblement, main dans la main], [barre], [ensem]]
adjectif: [[nom adjectif]]
alphabétique: [[abécédaire]]
du: [[synonyme 1, synonyme 2], [didu], [didu], [dó]]
néerlandais: [[flamand, hollandais, langue de Vondel], [flamand, hollandais]]
livre: [[indelicado, sem cadência]]
habitant: [[citoyen, résident, agriculteur, paysan, campagnard, :fr:Catégorie:Insultes en français québécois|Insultes en français québécois], [:fr:Catégorie:Insultes en français québécois|Insultes en français québécois], [inhabitant], [resident]]
texte: [[écrit, lettre]]
article: [[produit]]
élément: [[élément chimique]]
unitaire: [[socinien]]
chat: [[causette, clavardage, tchatche], [chat chastel], [pokec, webchat]]
blog: [[carnet Web, cybercarnet, joueb, jourel], [webový]]
sujet: [[enkeling, individu, kerel, knul, persoon, snuiter, vent]]
au: [[AU, ua], [ocell], [kiche]]
corps: [[chasse]]
gouvernement: [[overheid, regering]]
an: [[année], [ane]]
région: [[alentours de, coin, environ]]
nommer: [[synonyme 1, synonyme 2], [baptiser]]
animal: [[bestia, Catégorie:Animaux en papiamento|*]]
a priori: [[Catégorie:Animaux en roumain|*], [à première vue]]
calculateur: [[ordinateur, calculatrice]]
tu: [[tutaj], [você]]
électricité: [[courant, jus]]
maçon: [[bastisseire, murador, muraire]]
jeu: [[distraction, amusement, interprétation, exécution, tactique, fonctionnement, assortiment, latitude, rigolade, concours, ensemble, mène]]
système: [[infrastructure]]
grec: [[hellène, hellénique], [langue d’Homère, koinè], [gyros, kebab]]
singulier: [[différent, exceptionnel, extraordinaire]]
irrégulier: [[infréquent, sporadique]]
C: [[lo]]
mon: [[la vache, purée], [lo meu]]
ton: [[mun], [t’], [tonalité], [lo teu]]
son: [[bruit], [axır], [gut]]
student: [[vysokoškolák]]
astronomie: [[astro], [sterrenkunde], [sterrenkunde]]
ma: [[mama, mams, moeder]]
mes: [[midis, ndërmjet], [avat, hogen]]
ta: [[to]]
notre: [[boulba]]
nos: [[nosèl], [anos], [frňák]]
vos: [[politesse], [vosautres], [bos]]
leur: [[contrôleur, leurleur]]
aucun: [[nul, pas un], [pas un, personne]]
ouf: [[brrr]]
aïe: [[ahi, ayoye, ouille]]
argot: [[langue verte], [slang], [hantýrka, slang]]
slang: [[jargon, cant], [groepstaal, jargon, bargoens], [hantýrka, žargon]]
oh: [[zero]]
futur: [[à venir], [fiancé, promis]]
bar: [[buffet, bistrot], [loup], [baïart], [barri], [naken]]
barre: [[fer, rond]]
italien: [[langue de Dante, langue de l’amour]]
là: [[lì]]
tú: [[politesse]]
pluriel: [[plurier]]
marché: [[instrumentum, lot juridique]]
catalan: [[catalanique], [langue de Lulle, valencien]]
breton: [[langue bretonne], [cheval breton]]
utiliser: [[employer, exploiter, servir, user]]
synonyme: [[allonyme]]
latin: [[langue latine, langue de Cicéron]]
eau: [[kiche]]
but: [[obuwie]]
traduire: [[translater]]
pas: [[enjambée, rythme, graduation], [alleen, beklee, bekleed, klee, laat lyk, net, slegs], [mbas, pasi]]
quintal: [[cental]]
ich: [[pátio, terreiro], [ichil]]
finir: [[terminer, mourir], [acabar, terminar]]
中国: [[中华人民共和国], [中, 中華人民共和国, 支那], [中国地方]]
bienvenue: [[bonne arrivée]]
auparavant: [[d’abord, avant]]
enfant: [[enfantin]]
blanc: [[fi, finalitat, objectiu]]
welke: [[tortuse]]
Hongrois: [[Magyar]]
lui: [[klink], [egli]]
cardinal: [[écarlate, pourpre]]
premier: [[celui-là, premier étage, premier ministre]]
lentement: [[à pas de tortue, à pas d'homme, doucement]]
voire: [[pour ne pas dire]]
dorénavant: [[à présent, désormais, maintenant]]
dopage: [[doping]]
malveillant: [[malévole, malivole, malintentionné]]
malsain: [[scabreux]]
pareil: [[identique, similaire]]
gestion: [[administration, gérance]]
discipline: [[tucht]]
énoncer: [[formuler]]
extérieur: [[dehors]]
au-delà: [[autre monde]]
maison: [[domestique, fait maison]]
chaton: [[minet, iule, saule discolore, mouton]]
foyer: [[lobby]]
feu: [[défunt, regretté]]
déploiement: [[mahos, mahoso]]
russe: [[russien], [langue de Tolstoï, langue russe]]
avion: [[aéroplane, coucou, oiseau, taxi, zinc, zoziau], [aeroplanu], [aeroplan]]
ballon: [[baloune, ballon de baudruche, matras, référentiel bondissant]]
garçon: [[vaslet]]
bateau: [[arnaque, entourloupe, mener en bateau]]
aléatoire: [[hasardeux, hypothétique, probable, éventuel]]
se: [[kûçik, seg], [qla]]
page: [[valet]]
anticipation: [[prévision, préparation]]
mettre: [[placer, poser]]
décentration: [[empathie, recul, exteriorisation]]
montgolfière: [[ballon à air chaud]]
finnois: [[finlandais, suomi]]
serpent: [[serp, Catégorie:Serpents en catalan|*], [slang]]
normatif: [[prescriptif]]
excipit: [[explicit]]
oligarchie: [[oligocratie]]
cercle: [[rodona]]
agriculteur: [[cultivateur, éleveur, exploitant agricole, fermier, laboureur, paysan, producteur agricole]]
vasectomie: [[stérilisation, vasotomie]]
amphigouri: [[charabia, galimatias]]
efface: [[gomme, gomme à effacer]]
première: [[initiative, innovation]]
deuxième: [[second]]
troisième: [[tiers], [tiers]]
os: [[vultus]]
aquarium: [[bassin, cuve, réservoir, vivier]]
Royaume-Uni: [[Royaume de Grande-Bretagne, Royaume-Uni de Grande-Bretagne, Royaume-Uni de Grande-Bretagne et d’Irlande, Royaume-Uni de Grande-Bretagne et d’Irlande du Nord]]
prestation: [[service]]
accordéon: [[piano à bretelles, piano du pauvre, râlé-poussé]]
parlement: [[états], [volksvertegenwoordiging]]
quatrième: [[quart], [quart]]
cinquième: [[quint]]
étalon: [[standard]]
botanique: [[phytologique], [phytologie]]
végétal: [[plante]]
second: [[deuxième]]
polonais: [[langue de Mickiewicz], [lapin hermine, hermine]]
abacule: [[cube, mosaïque, tesselle]]
abaissable: [[dépliable, rabattable]]
abaissant: [[avilissant, dégradant, humiliant]]
hépatique: [[jécoraire]]
coréen: [[langue coréenne]]
médiéval: [[moyenâgeux]]
petit: [[descendant, fils, rejeton, ti-cul, flo]]